11111111111111111111111111
10000C0000000P0000000E0101
11111111111111111111111111