11111111111111
100100C00C0C01
10000111110001
1P0011E0000X01
11111111111111