11111111111111111111111111
10000C00E0000P0000000E0001
11111111111111111111111111