111111111111111111111
1P00000000000000000E1
100000000000000000001
100011000001111000001
100101000000010000001
100101000000010000001
100111111000010000001
100000010000010000001
100000010000010000001
100000011111110000001
1000000000000000C0001
10C000000000000000001
111111111111111111111
